   | 0 0 0 0 0 0 0 0 0 0 1 1 1 1 1 1 1 1 1 1 2 2 2 2 2 2 2
   | 0 1 2 3 4 5 6 7 8 9 0 1 2 3 4 5 6 7 8 9 0 1 2 3 4 5 6
---+------------------------------------------------------
00 | # # # # # # # # # # # # # # # # # # # # # # # # # # #
01 | # # # # # # # # # # . . . + . . . . # # # # # # # # #
02 | # # # # # # # # # # . . . + . . . . # # # # # # # # #
03 | # # # # # # # # # # . . . + . . . . # # # # # # # # #
04 | # # # # # # # # # # . . . + . . . . # # # # # # # # #
05 | # # # # # # # # # # . . . + . . . . # # # # # # # # #
06 | # # # # # . . . . . a + + + . . . . . . . # # # # # #
07 | # # # # # . . . . a + b . + . . a + + . . # # # # # #
08 | # # # # # . . + + + b . . + . a + b . . . # # # # # #
09 | # # # # # . . . . . . . . + + + b . . . . . . # # # #
10 | # # # # # . . . . . . . . + . . . . . . . . . # # # #
11 | # # # # # # . . . . . . . + . . . . . . . . . # # # #
12 | # # # # # # . . . . . . . + . . . . . . . . . # # # #
13 | # # # # # # . . . . . . . + . . . . . . . . . # # # #
14 | # # # # # # . . . . + + + + + + + . . . . . . # # # #
15 | # # # # # # . . . . . . . + . . . . . . . . . # # # #
16 | # # # # # # . . . . . . . + . . . . . . . . . # # # #
17 | # # # # # # . . . . . . . + . . . . . . . . . # # # #
18 | # # # # # # . . . . . . + + + . . . . . # # # # # # #
19 | # # # # # # . . . . + + + . + + + . . . # # # # # # #
20 | # # # # # # . . . . . . + + + . . . . . # # # # # # #
21 | # # # # # # . . . . . . . + . . . . . . # # # # # # #
22 | # # # # # # . . . . . . . + . . . . . . # # # # # # #
23 | # # # # # # # # . . . . . + . . . # # # # # # # # # #
24 | # # # # # # # # . . . . . . . . . # # # # # # # # # #
25 | # # # # # # # # . . . . . . . . . # # # # # # # # # #
26 | # # # # # # # # . . . . . . . . . # # # # # # # # # #
27 | # # # # # # # # . . . . . . . . . # # # # # # # # # #
28 | # # # # # # # # # # # # # # # # # # # # # # # # # # #